+++++++++++++++++++++
+         S         +
+  ++++++ + ++++++  +
+  +    + + +    +  +
+  + ++ + + + ++ +  +
+     +  + +  +     +
+  ++++++ + ++++++  +
+  +      +      +  +
+  +++++++++++++++  +
+                   E
+++++++++++++++++++++
