+++++++++++++++++++++++++++++++++++++
+S    +     +   +       +       +   +
+ +++ + +++ + + + +++++ + +++++ + + +
+   +   +   + +   +   + + +   +   + +
+++ +++++ ++++++++ + + + + + +++++ ++
+       +         + + + + + +     + +
+ +++++ + + +++++ + + + + + + +++ + +
+ +   +   +   +   + + +   + +   + + +
+ + + +++++++ + +++ + + +++ +++ + + +
+ + +     +   +   + + +   +   + + + +
+ + +++++ + +++++ + + +++ + + + + + +
+   +   + +   +   + +   + + + +   + +
+++ +++ + +++ + +++++++ + + +++++ + +
+     +   +   +   +             + + +
+ +++++ + + + +++ + +++ + + +++ + + +
+ +     + + +   +   +   + +   + + + +
+ + +++++ + + +++++ + ++++ +  + + + +
+ +   +   + +   +   +     +       + +
+ + + + + + +++ + +++++++++ +++++ + +
+   + + + +   +   +       +     +   E
+++++++++++++++++++++++++++++++++++++