++++++++++++++++++++++++
+S       ++++++       S+
+ ++++++ +    + ++++++ +
+ +    + +    + +    + +
+ + ++ + ++++++ + ++ + +
+ +    +        +    + +
+ ++++++ ++++++ ++++++ +
+        +    +        +
+ ++++++ +    + ++++++ +
+ +    + ++++++ +    + +
+ + ++ +        + ++ + +
+ +    + ++++++ +    + +
+ ++++++ +    + ++++++ +
+        +    +        +
++++++++++++E+++++++++++