+++++++++++++++++++++++++++++++
+              S              +
+        +++++++++++++        +
+      +++++++++++++++++      +
+    +++++++++++++++++++++    +
+   +++++++++++++++++++++++   +
+  +++++++++++++++++++++++++  +
+ +++++++++++++++++++++++++++ +
+ +++++++++++++++++++++++++++ +
+ +++++++++++++++++++++++++++ +
+ +++++++++++++++++++++++++++ +
+ +++++++++++++++++++++++++++ +
+ +++++++++++++++++++++++++++ +
+ +++++++++++++++++++++++++++ +
+ +++++++++++++++++++++++++++ +
+ +++++++++++++++++++++++++++ +
+ +++++++++++++++++++++++++++ +
+ +++++++++++++++++++++++++++ +
+E+++++++++++++++++++++++++++E+