+++++++++++++++++++
+        S        +
+ ++++++ + ++++++ +
+ +    + + +    + +
+ + ++ + + + ++ + +
+     + + + +     +
+ ++++++ + ++++++ +
+ +      +      + +
+  +++++++++++++  +
+                 E
+++++++++++++++++++
