+++++++++++++++++++++++++++
+S  +   ++ ++          +  E
+ +   +            +++ + ++
+ + +  ++++++  +++++++ + ++
+ + ++++++++++      ++ +  +
+               ++++      +
++++++ ++++++++++++++++++ +
+                   ++  + +
+ ++   +++++++++++++++  + +
+ ++++++              +   +
+                    ++ +++
+++++++++++++++++++++++E+++
